19,8
###################
#       <#>       #
# ############### #
# ############### #
# ############### #
# ############### #
#                 #
###################

