24,9
########################
#                      #
#                      #
#                      #
#                      #
#                      #
#  <                >  #
#                      #
########################

