21,21
#####################
#<          #       #
########### ####### #
#     # #   #       #
# ### # # ### #######
# #   #         #   #
# # ####### ### # # #
# #       #   # # # #
# ####### ### # ### #
# #     # # # #   # #
# ##### # # # # # # #
#       #   # # # # #
### ######### ### # #
# #           #   # #
# ####### ##### ### #
#       # #   #   # #
### ##### # # ### # #
#         # # # # # #
# ######### # # # # #
#           #   #  >#
#####################

